#東方Project辞書 for Google日本語入力 R13-20240901
#作成者 : きゅー(Cue)
#更新日 : 2024-09-01
#配布元 : https://9lab.jp/works/dic/th-dic/
#本ファイルは、同人サークル「上海アリス幻樂団」制作の弾幕系シューティングを中心としたゲーム、書籍、音楽CDなどから成る作品群「東方Project」関連の用語を、IMEに登録するための単語リストです。
#本辞書データは、「上海アリス幻樂団創作物の二次創作に関するガイドライン」(https://touhou-project.news/guideline/)の範囲内で自由に利用・複製・再配布することができます。

### ----- [ 用語辞書 ] -----
### 東方Project作品の関連用語が収録されています。

### サークル名
ずんそふと	ZUN Soft	名詞	サークル名〉原作（PC-98版時代）
しゃんはいありすげんがくだん	上海アリス幻樂団	名詞	サークル名〉原作
たそがれふろんてぃあ	黄昏フロンティア	名詞	サークル名〉共作
### サークル名:ゲーム楽曲提供先
しゅんさつされどう	瞬殺サレ道？	名詞	サークル名〉ゲーム楽曲提供先
のんべぇかい	呑んべぇ会	名詞	サークル名〉ゲーム楽曲提供先
でぃーえぬえーそふとうぇあ	D.N.A.Softwares	名詞	サークル名〉ゲーム楽曲提供先
ｄなそふとうぇあ	D.N.A.Softwares	名詞	サークル名〉ゲーム楽曲提供先
### 上海アリス幻樂団
はくれいげんそうしょふ	博麗幻想書譜	名詞	上海アリス幻樂団〉公式Blog
みゅうぢっくおぶろおたすらんど	東方幻想的音楽	名詞	上海アリス幻樂団〉旧公式サイト：MIDIとMP3のページ
あんていくげいむみゅうぢっく	東方幻想懐古曲	名詞	上海アリス幻樂団〉旧公式サイト：PMDのページ
ぽをとれいとおぶえきぞちっくがあるず	蓬莱少女繪幻想	名詞	上海アリス幻樂団〉旧公式サイト：イラストのページ
### 作者名
ずん	ZUN	人名	作者名〉東方Project原作者，博麗神主
ずｎ	ZUN	人名	作者名〉東方Project原作者，博麗神主
うなばらいるか	海原海豚	人名	作者名〉企画，ゲームデザイン：黄昏フロンティア作品
あきやまうに	あきやまうに	人名	作者名〉音楽：黄昏フロンティア作品
ときあめ	TOKIAME	人名	作者名〉挿絵：儚月抄（小説版）／イラスト：剛欲異聞
あきえだ	秋★枝	人名	作者名〉漫画：記憶する幻想郷，儚月抄（漫画版）
はにわ	葉庭	人名	作者名〉漫画：風の号外
あさいげんじ	唖采弦二	人名	作者名〉表紙絵：求聞史紀，書籍文花帖，GoM／挿絵：香霖堂
まつくらねむ	松倉ねむ	人名	作者名〉漫画：三月精第一部
ひらさかまこと	比良坂真琴	人名	作者名〉漫画：三月精第二部～第四部
あらたとしひら	あらたとしひら	人名	作者名〉漫画：儚月抄（4コマ版）
もりきたけし	守姫武士	人名	作者名〉挿絵：GoM
あずまあや	あずまあや	人名	作者名〉漫画：茨歌仙
はるかわもえ	春河もえ	人名	作者名〉漫画：鈴奈庵
ぎんもくせい	銀木犀	人名	作者名〉漫画：智霊奇伝（～第二章）
あきまきゆう	秋巻ゆう	人名	作者名〉漫画：智霊奇伝（第三章～）
みずたき	水炊き	人名	作者名〉漫画：酔蝶華
ぴえとろ	ぴえとろ	人名	作者名〉ゲーム：トルテルマジック
### 用語:ゲームシステム関連
あたりはんてい	当たり判定	名詞	用語〉ゲーム〉共通
あんち	安地	名詞	用語〉ゲーム〉共通
うぃるすだん	ウィルス弾	名詞	用語〉ゲーム〉共通
うえよけ	上避け	名詞サ変	用語〉ゲーム〉共通
うそよけ	嘘避け	名詞サ変	用語〉ゲーム〉共通
うちかえしだん	撃ち返し弾	名詞	用語〉ゲーム〉共通
うろこだん	鱗弾	名詞	用語〉ゲーム〉共通
えくすてんど	エクステンド	名詞サ変	用語〉ゲーム〉共通
おーらうち	オーラ撃ち	名詞サ変	用語〉ゲーム〉共通
かかえおち	抱え落ち	名詞サ変	用語〉ゲーム〉共通
かす	カス	動詞ラ行五段	用語〉ゲーム〉共通
きあいよけ	気合避け	名詞サ変	用語〉ゲーム〉共通
きすうだん	奇数弾	名詞	用語〉ゲーム〉共通
きめぼむ	決めボム	名詞	用語〉ゲーム〉共通
ぐうすうだん	偶数弾	名詞	用語〉ゲーム〉共通
くさびだん	楔弾	名詞	用語〉ゲーム〉共通
くないだん	クナイ弾	名詞	用語〉ゲーム〉共通
くらいぼむ	喰らいボム	名詞サ変	用語〉ゲーム〉共通
ぐれいず	グレイズ	名詞サ変	用語〉ゲーム〉共通
こがたなだん	小刀弾	名詞	用語〉ゲーム〉共通
ごくしょうだん	極小弾	名詞	用語〉ゲーム〉共通
こていだん	固定弾	名詞	用語〉ゲーム〉共通
こめつぶだん	米粒弾	名詞	用語〉ゲーム〉共通
ざやくだん	坐薬弾	名詞	用語〉ゲーム〉共通
ざんきのかけら	残機の欠片	名詞	用語〉ゲーム〉共通
じきねらいだん	自機狙い弾	名詞	用語〉ゲーム〉共通
しょうじょきとうちゅう	少女祈祷中	名詞	用語〉ゲーム〉共通（Now Loading）
しりうち	尻撃ち	名詞サ変	用語〉ゲーム〉共通
すぺか	スペカ	名詞	用語〉ゲーム〉共通
すぺるかーど	スペルカード	名詞	用語〉ゲーム〉共通
ぜんほういだん	全方位弾	名詞	用語〉ゲーム〉共通
たいきゅうすぺる	耐久スペル	名詞	用語〉ゲーム〉共通
たいきゅうだんまく	耐久弾幕	名詞	用語〉ゲーム〉共通
だえんだん	楕円弾	名詞	用語〉ゲーム〉共通
ちきんぼむ	チキンボム	名詞	用語〉ゲーム〉共通
ちょうだん	蝶弾	名詞	用語〉ゲーム〉共通
ちょんよけ	チョン避け	名詞サ変	用語〉ゲーム〉共通
ついびだん	追尾弾	名詞	用語〉ゲーム〉共通
つうじょうだん	通常弾	名詞	用語〉ゲーム〉共通
つぶだん	粒弾	名詞	用語〉ゲーム〉共通
てんだん	点弾	名詞	用語〉ゲーム〉共通
とくてんあいてむ	得点アイテム	名詞	用語〉ゲーム〉共通
どっぷらーうち	ドップラー撃ち	名詞	用語〉ゲーム〉共通
ないふだん	ナイフ弾	名詞	用語〉ゲーム〉共通
はしよけ	端避け	名詞サ変	用語〉ゲーム〉共通
ばらまきだん	バラ撒き弾	名詞	用語〉ゲーム〉共通
はりだん	針弾	名詞	用語〉ゲーム〉共通
はりみこ	針巫女	名詞	用語〉ゲーム〉共通
ひかりだん	光弾	名詞	用語〉ゲーム〉共通
ぴちゅ	ピチュ	動詞ラ行五段	用語〉ゲーム〉共通
ぴちゅーん	ピチューン	名詞サ変	用語〉ゲーム〉共通
びびりぼむ	びびりボム	名詞	用語〉ゲーム〉共通
ふだだん	札弾	名詞	用語〉ゲーム〉共通
ぶどうだん	葡萄弾	名詞	用語〉ゲーム〉共通
ふるぱわーあいてむ	フルパワーアイテム	名詞	用語〉ゲーム〉共通
ぺなるてぃだん	ペナルティ弾	名詞	用語〉ゲーム〉共通
へにょりれーざー	へにょりレーザー	名詞	用語〉ゲーム〉共通
ほーみんぐだん	ホーミング弾	名詞	用語〉ゲーム〉共通
ほしがただん	星型弾	名詞	用語〉ゲーム〉共通
ほしだん	星弾	名詞	用語〉ゲーム〉共通
ぼむのかけら	ボムの欠片	名詞	用語〉ゲーム〉共通
ぼむばりあ	ボムバリア	名詞	用語〉ゲーム〉共通
みさまり	ミサマリ	名詞	用語〉ゲーム〉共通
みっちゃくうちこみ	密着撃ち込み	名詞	用語〉ゲーム〉共通
やじるしだん	矢印弾	名詞	用語〉ゲーム〉共通
ゆみだん	弓弾	名詞	用語〉ゲーム〉共通
らんだむだん	ランダム弾	名詞	用語〉ゲーム〉共通
りんぐだん	リング弾	名詞	用語〉ゲーム〉共通
れいげき	霊撃	名詞	用語〉ゲーム〉共通
れざまり	レザマリ	名詞	用語〉ゲーム〉共通
わんあっぷあいてむ	1UPアイテム	名詞	用語〉ゲーム〉共通
わんなっぷあいてむ	1UPアイテム	名詞	用語〉ゲーム〉共通
えんだん	炎弾	名詞	用語〉ゲーム〉紅大
ほのおだん	炎弾	名詞	用語〉ゲーム〉紅大
さくらてん	桜点	名詞	用語〉ゲーム〉妖
しんらけっかい	森羅結界	名詞	用語〉ゲーム〉妖
ぼーだーぼーなす	ボーダーボーナス	名詞	用語〉ゲーム〉妖
あかまりすほう	赤マリス砲	名詞	用語〉ゲーム〉永
あやかしりつ	妖率	名詞	用語〉ゲーム〉永
うらまりすほう	裏マリス砲 	名詞	用語〉ゲーム〉永
おうまがとき	逢魔が時	名詞	用語〉ゲーム〉永
けっしけっかい	決死結界	名詞	用語〉ゲーム〉永
こくふあいてむ	刻符アイテム	名詞	用語〉ゲーム〉永
じんようてん	人妖点	名詞	用語〉ゲーム〉永
すぺるぷらくてぃす	スペルプラクティス	名詞	用語〉ゲーム〉永神輝天
つかいま	使い魔	名詞	用語〉ゲーム〉永
でぃぞるぶすぺる	ディゾルブスペル	名詞	用語〉ゲーム〉永
まりすほう	マリス砲	名詞	用語〉ゲーム〉永
らすとすぺる	ラストスペル	名詞	用語〉ゲーム〉永
らすとわーど	ラストワード	名詞	用語〉ゲーム〉永心
らすとわーど	LastWord	名詞	用語〉ゲーム〉永心
かいかせんげん	開花宣言	名詞	用語〉ゲーム〉花
だんまくかいかせんげん	弾幕開花宣言	名詞	用語〉ゲーム〉花
かゆだん	粥弾	名詞	用語〉ゲーム〉風
ぐらまり	グラマリ	名詞	用語〉ゲーム〉風
がーどくらっしゅ	ガードクラッシュ	名詞	用語〉ゲーム〉緋非深
かいひけっかい	回避結界	名詞	用語〉ゲーム〉緋非
しすか	シスカ	名詞	用語〉ゲーム〉緋非
しすてむかーど	システムカード	名詞	用語〉ゲーム〉緋非
れいりょく	霊力	名詞	用語〉ゲーム〉緋非
えんかくれいげき	遠隔霊撃	名詞	用語〉ゲーム〉地
かくだん	核弾	名詞	用語〉ゲーム〉地
こうしんきょうど	交信強度	名詞	用語〉ゲーム〉地
はーとだん	ハート弾	名詞	用語〉ゲーム〉地輝
ばらだん	薔薇弾	名詞	用語〉ゲーム〉地
すいてきだん	水滴弾	名詞	用語〉ゲーム〉星
ぺんでゅらむ	ペンデュラム	名詞	用語〉ゲーム〉星
べんとらーあいてむ	ベントラーアイテム	名詞	用語〉ゲーム〉星
こおりぱわー	こおりパワー	名詞	用語〉ゲーム〉大
あおしんれい	青神霊	名詞	用語〉ゲーム〉神
おーばーどらいぶ	overdrive	名詞	用語〉ゲーム〉神
しょうしんれい	小神霊	名詞	用語〉ゲーム〉神
しろしんれい	白神霊	名詞	用語〉ゲーム〉神
みどりしんれい	緑神霊	名詞	用語〉ゲーム〉神
むらさきしんれい	紫神霊	名詞	用語〉ゲーム〉神
れいかいげーじ	霊界ゲージ	名詞	用語〉ゲーム〉神
れいかいとらんす	霊界トランス	名詞	用語〉ゲーム〉神
あいてむかーど	アイテムカード	名詞	用語〉ゲーム〉心
にんきど	人気度	名詞	用語〉ゲーム〉心
おんぷだん	音符弾	名詞	用語〉ゲーム〉輝
きゅうふだん	休符弾	名詞	用語〉ゲーム〉輝
たいこだま	太鼓弾	名詞	用語〉ゲーム〉輝
おかるとあたっく	オカルトアタック	名詞	用語〉ゲーム〉深
おかるとぼーる	オカルトボール	名詞	用語〉ゲーム〉深
おかるとわざ	オカルト技	名詞	用語〉ゲーム〉深
かいらすとわーど	怪ラストワード	名詞	用語〉ゲーム〉深憑
おおかみれい	オオカミ霊	名詞	用語〉ゲーム〉鬼
おおわしれい	オオワシ霊	名詞	用語〉ゲーム〉鬼
かわうそれい	カワウソ霊	名詞	用語〉ゲーム〉鬼
どうぶつれいあいてむ	動物霊アイテム	名詞	用語〉ゲーム〉鬼
ぼうそうろありんぐもーど	暴走ロアリングモード	名詞	用語〉ゲーム〉鬼
ろありんぐもーど	ロアリングモード	名詞	用語〉ゲーム〉鬼
あびりてぃかーど	アビリティカード	名詞	用語〉ゲーム〉虹
しようかーど	使用カード	名詞	用語〉ゲーム〉虹（アビリティカード）
そうびかーど	装備カード	名詞	用語〉ゲーム〉虹（アビリティカード）
そっこうかーど	即効カード	名詞	用語〉ゲーム〉虹（アビリティカード）
のうりょくかーど	能力カード	名詞	用語〉ゲーム〉虹（アビリティカード）
てんそく	天則	名詞	用語〉ゲーム〉非（非想天則の略称）
だんか	弾貨	名詞	用語〉ゲーム〉BP
### 用語:世界観
げんそうきょう	幻想郷	固有名詞	用語〉世界観〉一般
まぼろしとじったいのきょうかい	幻と実体の境界	固有名詞	用語〉世界観〉一般
はくれいだいけっかい	博麗大結界	固有名詞	用語〉世界観〉一般
はくれいのみこ	博麗の巫女	固有名詞	用語〉世界観〉一般
そとのせかい	外の世界	固有名詞	用語〉世界観〉一般
だんまくごっこ	弾幕ごっこ	固有名詞	用語〉世界観〉一般
げんそうきょうふうどき	幻想郷風土記	固有名詞	用語〉世界観〉史料
すぺるかーどるーる	スペルカードルール	固有名詞	用語〉世界観〉規則
すぺるかーどるーる	命名決闘法案	固有名詞	用語〉世界観〉規則
めいめいけっとうほうあん	命名決闘法案	固有名詞	用語〉世界観〉規則
ようかいかくちょうけいかく	妖怪拡張計画	固有名詞	用語〉世界観〉計画
ゆうれいいみんけいかく	幽霊移民計画	固有名詞	用語〉世界観〉計画
すみよしけいかく	住吉計画	固有名詞	用語〉世界観〉計画
すみよしげつめんしんりゃくけいかく	住吉月面侵略計画	固有名詞	用語〉世界観〉計画
ぷろじぇくとすみよし	住吉月面侵略計画	固有名詞	用語〉世界観〉計画
こうむいへん	紅霧異変	固有名詞	用語〉世界観〉異変・事件・騒動（紅魔郷）
しゅんせついへん	春雪異変	固有名詞	用語〉世界観〉異変・事件・騒動（妖々夢）
ゆうれいそうどう	幽霊騒動	固有名詞	用語〉世界観〉異変・事件・騒動（妖々夢）
みっかおきのひゃっきやこう	三日置きの百鬼夜行	固有名詞	用語〉世界観〉異変・事件・騒動（萃夢想）
えいやいへん	永夜異変	固有名詞	用語〉世界観〉異変・事件・騒動（永夜抄）
ろくじゅうねんしゅうきのだいけっかいいへん	六十年周期の大結界異変	固有名詞	用語〉世界観〉異変・事件・騒動（花映塚）
だいにじげつめんせんそう	第二次月面戦争	固有名詞	用語〉世界観〉異変・事件・騒動（儚月抄）
さかさまいへん	逆様異変	固有名詞	用語〉世界観〉異変・事件・騒動（輝針城）
げんそうげつめんせんそうそうどう	幻想月面戦争騒動	固有名詞	用語〉世界観〉異変・事件・騒動（第一次月面戦争）
だいけっかいそうどう	大結界騒動	固有名詞	用語〉世界観〉異変・事件・騒動
きゅうけつきいへん	吸血鬼異変	固有名詞	用語〉世界観〉異変・事件・騒動
ようせいだいせんそう	妖精大戦争	固有名詞	用語〉世界観〉異変・事件・騒動（妖精大戦争）
としでんせついへん	都市伝説異変	固有名詞	用語〉世界観〉異変・事件・騒動（深秘録）
かんぜんひょういいへん	完全憑依異変	固有名詞	用語〉世界観〉異変・事件・騒動（憑依華）
しきいへん	四季異変	固有名詞	用語〉世界観〉異変・事件・騒動（天空璋）
ようかいたいいんれき	妖怪太陰暦	固有名詞	用語〉世界観〉その他
### 用語:種族
ようじゅう	妖獣	名詞	用語〉種族
てんま	天魔	名詞	用語〉種族（天狗たちの長）
からすてんぐ	鴉天狗	名詞	用語〉種族（広報）
だいてんぐ	大天狗	名詞	用語〉種族（管理職）
はなたかてんぐ	鼻高天狗	名詞	用語〉種族（事務職）
はくろうてんぐ	白狼天狗	名詞	用語〉種族（警備）
やまぶしてんぐ	山伏天狗	名詞	用語〉種族（印刷業）
つきびと	月人	名詞	用語〉種族
ぎょくと	玉兎	名詞	用語〉種族
はんじんはんれい	半人半霊	名詞	用語〉種族
ほうらいびと	蓬莱人	名詞	用語〉種族
やおよろずのかみ	八百万の神	名詞	用語〉種族
どちゃくしん	土着神	名詞	用語〉種族
あまつかみ	天津神	名詞	用語〉種族
よすずめ	夜雀	名詞	用語〉種族
わーはくたく	ワーハクタク	名詞	用語〉種族
つるべおとし	釣瓶落とし	名詞	用語〉種族
じごくがらす	地獄鴉	名詞	用語〉種族
めんれいき	面霊気	名詞	用語〉種族
ひしん	秘神	名詞	用語〉種族
やまじょろう	山女郎	名詞	用語〉種族
すいま	酔魔	名詞	用語〉種族
### 用語:地名
げんむかい	幻夢界	地名	用語〉地名（PC-98）
むげんせかい	夢幻世界	地名	用語〉地名（PC-98）
にんげんのさと	人間の里	地名	用語〉地名
まほうのもり	魔法の森	地名	用語〉地名
きりのみずうみ	霧の湖	地名	用語〉地名
まよいが	マヨヒガ	地名	用語〉地名
めいかい	冥界	地名	用語〉地名
まよいのちくりん	迷いの竹林	地名	用語〉地名
たいようのはたけ	太陽の畑	地名	用語〉地名
むめいのおか	無名の丘	地名	用語〉地名
さいしのみち	再思の道	地名	用語〉地名
むえんづか	無縁塚	地名	用語〉地名
むらさきのさくら	紫の桜	地名	用語〉地名（無縁塚）
さんずのかわ	三途の川	地名	用語〉地名
さいのかわら	賽の河原	地名	用語〉地名
ひがん	彼岸	地名	用語〉地名（三途の川の向こう岸）
ようかいのやま	妖怪の山	地名	用語〉地名
げんぶのさわ	玄武の沢	地名	用語〉地名（妖怪の山の麓）
くてんのたき	九天の滝	地名	用語〉地名（妖怪の山）
きゅうてんのたき	九天の滝	地名	用語〉地名（妖怪の山）
おおがまのいけ	大蝦蟇の池	地名	用語〉地名（妖怪の山の中腹）
ちゅううのみち	中有の道	地名	用語〉地名（妖怪の山の裏側と三途の川の間）
きゅうじごく	旧地獄	地名	用語〉地名
きゅうじごくかいどう	旧地獄街道	地名	用語〉地名
きゅうと	旧都	地名	用語〉地名
しゃくねつじごくあと	灼熱地獄跡	地名	用語〉地名
まかい	魔界	地名	用語〉地名
ほっかい	法界	地名	用語〉地名（魔界）
てんかい	天界	地名	用語〉地名
せんかい	仙界	地名	用語〉地名
うちょうてん	有頂天	地名	用語〉地名
つきのみやこ	月の都	地名	用語〉地名（月の裏側）
ちくしょうかい	畜生界	地名	用語〉地名
うしろどのくに	後戸の国	地名	用語〉地名
こうりゅうどう	虹龍洞	地名	用語〉地名（妖怪の山）
ひてんがけ	秘天崖	地名	用語〉地名
ぎてんだな	偽天棚	地名	用語〉地名
### 用語:施設,建造物
れいまでん	靈魔殿	固有名詞	用語〉施設・建造物（PC-98）
むげんいせき	夢幻遺跡	固有名詞	用語〉施設・建造物（PC-98）（可能性空間移動船）
かのうせいくうかんいどうせん	可能性空間移動船	固有名詞	用語〉施設・建造物（PC-98）
むげんかん	夢幻館	固有名詞	用語〉施設・建造物（PC-98）
はくれいじんじゃ	博麗神社	固有名詞	用語〉施設・建造物（幻想郷の東の端）
こうまかん	紅魔館	固有名詞	用語〉施設・建造物（妖怪の山の麓，霧の湖の畔）
はいようかん	廃洋館	固有名詞	用語〉施設・建造物（霧の湖付近）
はくぎょくろう	白玉楼	固有名詞	用語〉施設・建造物（冥界）
さいぎょうあやかし	西行妖	固有名詞	用語〉施設・建造物（白玉楼に生えている桜）
えいえんてい	永遠亭	固有名詞	用語〉施設・建造物（迷いの竹林）
ぜひきょくちょくちょう	是非曲直庁	固有名詞	用語〉施設・建造物（地獄）
もりやじんじゃ	守矢神社	固有名詞	用語〉施設・建造物（妖怪の山）
ちれいでん	地霊殿	固有名詞	用語〉施設・建造物（旧地獄）
みょうれんじ	命蓮寺	固有名詞	用語〉施設・建造物（人間の里の外れ）
せいれんせん	聖輦船	固有名詞	用語〉施設・建造物
かんけつせんちかせんたー	間欠泉地下センター	固有名詞	用語〉施設・建造物（妖怪の山の麓）
ゆめどのだいしびょう	夢殿大祀廟	固有名詞	用語〉施設・建造物（命蓮寺の地下）
しんれいびょう	神霊廟	固有名詞	用語〉施設・建造物（夢殿大祀廟→仙界）
きしんじょう	輝針城	固有名詞	用語〉施設・建造物
こうりんどう	香霖堂	固有名詞	用語〉施設・建造物（魔法の森の入口）
すずなあん	鈴奈庵	固有名詞	用語〉施設・建造物（人間の里）
きりさめまほうてん	霧雨魔法店	固有名詞	用語〉施設・建造物（魔法の森）
れいちょうえん	霊長園	固有名詞	用語〉施設・建造物（畜生界）
ひがしふかみこうこう	東深見高校	固有名詞	用語〉施設・建造物（外の世界，関東）
げいどんてい	鯢呑亭	固有名詞	用語〉施設・建造物（人間の里）
### 用語:組織,団体
ようがくだん	幺樂団	固有名詞	用語〉組織・団体（音楽バンド）
ひふうくらぶ	秘封倶楽部	固有名詞	用語〉組織・団体（サークル）（初代会長：菫子）
くさのねようかいねっとわーく	草の根妖怪ネットワーク	固有名詞	用語〉組織・団体
とかくどうめい	兎角同盟	固有名詞	用語〉組織・団体
とかくどうめいせいやく	兎角同盟製薬	固有名詞	用語〉組織・団体
いーぐるらゔぃ	イーグルラヴィ	固有名詞	用語〉組織・団体（調査部隊）
きけつぐみ	鬼傑組	固有名詞	用語〉組織・団体（派閥）（組長：八千慧）
けいがぐみ	勁牙組	固有名詞	用語〉組織・団体（派閥）（組長：早鬼）
ごうよくどうめい	剛欲同盟	固有名詞	用語〉組織・団体（派閥）（盟主：尤魔）
はにわへいだん	埴輪兵団	固有名詞	用語〉組織・団体（兵団）（兵長：磨弓）
ちょうじゅうぎがく	鳥獣伎楽	固有名詞	用語〉組織・団体（音楽バンド）
### 用語:アイテム
ぶんぶんまるしんぶん	文々。新聞	固有名詞	用語〉アイテム〉新聞（発行者：射命丸文）
かかしねんぽう	花果子念報	固有名詞	用語〉アイテム〉新聞（発行者：姫海棠はたて）
げんそうきょうえんぎ	幻想郷縁起	固有名詞	用語〉アイテム〉書物（著者：稗田阿求）
すべてようかいのしわざなのか	全て妖怪の仕業なのか	固有名詞	用語〉アイテム〉書物（著者：アガサクリスQ）
きゅーのてつがく	『Q』の哲学	固有名詞	用語〉アイテム〉書物（著者：アガサクリスQ）
ｑのてつがく	『Q』の哲学	固有名詞	用語〉アイテム〉書物（著者：アガサクリスQ）
きりさめのつるぎ	霧雨の剣	固有名詞	用語〉アイテム（霖之助）（草薙の剣）
つきのはごろも	月の羽衣	固有名詞	用語〉アイテム
ふぇむとふぁいばー	フェムトファイバー	固有名詞	用語〉アイテム
しざるちゃん	四猿ちゃん	固有名詞	用語〉アイテム
いばらきのひゃくやくます	茨木の百薬枡	固有名詞	用語〉アイテム（華扇）
ようまぼん	妖魔本	固有名詞	用語〉アイテム
きぼうのめん	希望の面	固有名詞	用語〉アイテム（神子）
おんみょうぎょく	陰陽玉	固有名詞	用語〉アイテム（霊夢）
おんみょうだま	陰陽玉	固有名詞	用語〉アイテム（霊夢）
みにはっけろ	ミニ八卦炉	固有名詞	用語〉アイテム（魔理沙）
はくろうけん	白楼剣	固有名詞	用語〉アイテム（妖夢）（人間の迷いを断ち斬る事が出来る短剣）
ろうかんけん	楼観剣	固有名詞	用語〉アイテム（妖夢）（一振りで幽霊10匹分の殺傷力を持つ長刀）
つばめのこやすがい	燕の子安貝	固有名詞	用語〉アイテム（輝夜）
ひねずみのかわごろも	火鼠の皮衣	固有名詞	用語〉アイテム（輝夜）
ほとけのみいしのはち	仏の御石の鉢	固有名詞	用語〉アイテム（輝夜）
りゅうのくびのたま	龍の頸の玉	固有名詞	用語〉アイテム（輝夜）
ほうらいのたまのえ	蓬莱の玉の枝	固有名詞	用語〉アイテム（輝夜）
ほうらいのくすり	蓬莱の薬	固有名詞	用語〉アイテム
ひそうのつるぎ	緋想の剣	固有名詞	用語〉アイテム（天子）
かなめいし	要石	固有名詞	用語〉アイテム（天子）
ほうとう	宝塔	固有名詞	用語〉アイテム（星）
まじんきょうかん	魔人経巻	固有名詞	用語〉アイテム（白蓮）
しょうたいふめいのたね	正体不明の種	固有名詞	用語〉アイテム（ぬえ）
かいごぼう	悔悟棒	固有名詞	用語〉アイテム（四季映姫）
じょうはりのかがみ	浄玻璃の鏡	固有名詞	用語〉アイテム（四季映姫）
### 用語:Music Room
れんれんおんがくかん	恋々音樂館	固有名詞	Music Room〉紅魔郷
ようようおんがくしつ	妖々音樂室	固有名詞	Music Room〉妖々夢
むそうきょくばっすい	夢想曲抜萃	固有名詞	Music Room〉萃夢想
よひとよがくだん	夜一夜樂団	固有名詞	Music Room〉永夜抄
きこうおんがくしつ	季候音楽室	固有名詞	Music Room〉花映塚
ぶんきゅうのしらべ	文久の調べ	固有名詞	Music Room〉文花帖
かみがみのきゅうけいじょ	神々の休憩所	固有名詞	Music Room〉風神録
ちょっとおちゃでも	ちょっとお茶でも	固有名詞	Music Room〉地霊殿
だいめいのいらないおんがくしつ	題名のいらない音楽室	固有名詞	Music Room〉星蓮船
やまのおんがくしつ	山の音楽室	固有名詞	Music Room〉ダブルスポイラー
おんがくをきこう	おんがくをきこう！	固有名詞	Music Room〉妖精大戦争
れいかいおんがくしつ	霊界音楽室	固有名詞	Music Room〉神霊廟
かがやけおんがくしつ	輝け！音楽室	固有名詞	Music Room〉輝針城
はんげきのおんがくしつ	反撃の音楽室	固有名詞	Music Room〉アマノジャク
けがれなきおんがくしつ	穢れなき音楽室	固有名詞	Music Room〉紺珠伝
しきおりおりのおんがくしつ	四季折々の音楽室	固有名詞	Music Room〉天空璋
ひふうおんがくしつ	秘封音楽室	固有名詞	Music Room〉秘封ND
ひゃくじゅうのおんがくしつ	百獣の音楽室	固有名詞	Music Room〉鬼形獣
こうげいのおんがくしつ	虹霓の音楽室	固有名詞	Music Room〉虹龍洞
じゅうおうたちのおんがくしつ	獣王達の音楽室	固有名詞	Music Room〉獣王園
### 用語:その他
げっとばんしょうてん	月都万象展	固有名詞	用語〉その他
みらいすいようばざー	未来水妖バザー	固有名詞	用語〉その他
むしのしらせさーびす	蟲の知らせサービス	固有名詞	用語〉その他
はんれい	半霊	名詞	用語〉その他
みあれ	御阿礼	名詞	用語〉その他
みあれのこ	御阿礼の子	名詞	用語〉その他
あれおとめ	阿礼乙女	名詞	用語〉その他
あれおとこ	阿礼男	名詞	用語〉その他
ずんぼう	ZUN帽	名詞	用語〉その他
はるつげせい	春告精	名詞	用語〉その他
ぷりずむりばーさんしまい	プリズムリバー三姉妹	名詞	用語〉その他
そうれいさんしまい	騒霊三姉妹	名詞	用語〉その他
さんようせい	三妖精	名詞	用語〉その他
ひかりのさんようせい	光の三妖精	名詞	用語〉その他
こうま	紅魔	名詞	用語〉その他
ああそうかい	亜阿相界	名詞	用語〉その他
ひょうせい	氷精	名詞	用語〉その他
あつま	萃ま	動詞ラ行五段	用語〉その他
あつめ	萃め	一段動詞	用語〉その他
しかいせん	尸解仙	名詞	用語〉その他
しゅてんどうじ	酒呑童子	名詞	用語〉その他
ひとうばん	飛頭蛮	名詞	用語〉その他
るーがるー	ルーガルー	名詞	用語〉その他
けろちゃん	ケロちゃん	名詞	用語〉その他
みしゃぐじさま	ミシャグジ様	名詞	用語〉その他
ぐもんじ	求聞持	名詞	用語〉その他
ひふう	秘封	名詞	用語〉その他
わらべまつり	童祭	名詞	用語〉その他
わきみこ	腋巫女	名詞	用語〉その他
### 情報発信メディア
とうほうぷろじぇくとよもやまにゅーす	東方Projectよもやまニュース	固有名詞	情報発信メディア〉Webサイト
よもやまにゅーす	東方Projectよもやまニュース	短縮よみ	情報発信メディア〉Webサイト
よもやまにゅーす	よもやまニュース	固有名詞	情報発信メディア〉Webサイト
とうほうがらくたそうし	東方我楽多叢誌 ～strange article of the outer world～	短縮よみ	情報発信メディア〉Webサイト
とうほうがらくたそうし	東方我楽多叢誌	固有名詞	情報発信メディア〉Webサイト
がらくたそうし	我楽多叢誌	固有名詞	情報発信メディア〉Webサイト
とうほうすてーしょん	東方ステーション	固有名詞	情報発信メディア〉動画配信番組
とうほうすてーしょん	東方STATION	固有名詞	情報発信メディア〉動画配信番組
### イベント名
はくれいじんじゃれいたいさい	博麗神社例大祭	固有名詞	イベント〉同人即売会
はくれいじんじゃれいたいさいすぺしゃる	博麗神社例大祭SP	固有名詞	イベント〉同人即売会
はくれいじんじゃしゅうきれいたいさい	博麗神社秋季例大祭	固有名詞	イベント〉同人即売会
たいわんれいたいさい	台湾例大祭	固有名詞	イベント〉同人即売会
しゅうきれいたいさい	秋季例大祭	固有名詞	イベント〉同人即売会
れいたいさいすぺしゃる	例大祭SP	固有名詞	イベント〉同人即売会
れいたいさい	例大祭	固有名詞	イベント〉同人即売会
とうほうこうろうむ	東方紅楼夢	固有名詞	イベント〉同人即売会
こうろうむ	紅楼夢	固有名詞	イベント〉同人即売会
とうほうかむいさい	東方神居祭	固有名詞	イベント〉同人即売会
かむいさい	神居祭	固有名詞	イベント〉同人即売会
とうほうすうけいさい	東方崇敬祭	固有名詞	イベント〉同人即売会
すうけいさい	崇敬祭	固有名詞	イベント〉同人即売会
ようがくだんかぁにばる	幺樂団カァニバル！	固有名詞	イベント〉同人即売会
ようがくだんかーにばる	幺樂団カァニバル！	固有名詞	イベント〉同人即売会
すいかといっしょ	すいかといっしょ	固有名詞	イベント〉同人即売会
かげきのうたげ	華激ノ宴	固有名詞	イベント〉同人即売会
とうほうけいこうさい	東方蛍光祭	固有名詞	イベント〉同人即売会
けいこうさい	蛍光祭	固有名詞	イベント〉同人即売会
きょうかいからみえたけしき	境界から視えた外界	固有名詞	イベント〉同人即売会
ちていのどくしんさいばん	地底の読心裁判	固有名詞	イベント〉同人即売会
とうほうごうどうさいじ	東方合同祭事	固有名詞	イベント〉同人即売会
つきのうたげ	月の宴	固有名詞	イベント〉同人即売会
とうほうれいげつさい	東方例月祭	固有名詞	イベント〉同人即売会
れいげつさい	例月祭	固有名詞	イベント〉同人即売会
あかのひろば	紅のひろば	固有名詞	イベント〉同人即売会
ようせいげんき	ようせいげんき！	固有名詞	イベント〉同人即売会
はかくらやっほー	はかくらやっほー	固有名詞	イベント〉同人即売会
ちょうじゅうやっほー	鳥獣やっほー	固有名詞	イベント〉同人即売会
ぎゃてぎゃてやっほー	ぎゃてぎゃてやっほー	固有名詞	イベント〉同人即売会
とうほうそうなのか	東方想七日	固有名詞	イベント〉同人即売会
そうなのか	想七日	固有名詞	イベント〉同人即売会
とうほうれじゃーらんど	東方レジャーランド	固有名詞	イベント〉同人即売会
とうきょうなずーりんらんど	東京ナズーリンランド	固有名詞	イベント〉同人即売会
やくもさふぁりぱーく	八雲サファリパーク	固有名詞	イベント〉同人即売会
すわふうじんさい	諏訪風神祭	固有名詞	イベント〉同人即売会
すわじんしゅうさい	諏訪神秋祭	固有名詞	イベント〉同人即売会
とうほうたえんさい	東方多宴祭	固有名詞	イベント〉同人即売会
たえんさい	多宴祭	固有名詞	イベント〉同人即売会
すずなげんそうえまき	鈴奈幻想絵巻	固有名詞	イベント〉同人即売会
とうほうめいかさい	東方名華祭	固有名詞	イベント〉同人即売会
めいかさい	名華祭	固有名詞	イベント〉同人即売会
しんげつようまやこう	新月妖魔夜行	固有名詞	イベント〉同人即売会
とれじゃーぱーてぃー	とれじゃーぱーてぃー！	固有名詞	イベント〉同人即売会
げんそうきょうふぉーらむ	幻想郷フォーラム	固有名詞	イベント〉同人即売会
あんだーぐらうんどかーにばる	アンダーグラウンドカーニバル	固有名詞	イベント〉同人即売会
げんそうきょうさみっと	幻想郷サミット	固有名詞	イベント〉同人即売会
みょうれんじだいえんにち	命蓮寺大縁日	固有名詞	イベント〉同人即売会
たいしさまふっかつさい	太子さま復活祭	固有名詞	イベント〉同人即売会
げんそうはなまつり	幻想花まつり	固有名詞	イベント〉同人即売会
とうほうめいげつさい	東方名月祭	固有名詞	イベント〉同人即売会
ほうらいかれいどすこおぷ	蓬莱カレイドスコオプ	固有名詞	イベント〉同人即売会
ほうらいかれいどすこーぷ	蓬莱カレイドスコオプ	固有名詞	イベント〉同人即売会
こめいじこんぷれっくす	古明地こんぷれっくす	固有名詞	イベント〉同人即売会
ぶんぶんまるしんぶんとものかい	文々。新聞友の会	固有名詞	イベント〉同人即売会
かがくせいきのかふぇてらす	科学世紀のカフェテラス	固有名詞	イベント〉同人即売会
きゅうだいめのこうちゃかい	求代目の紅茶会	固有名詞	イベント〉同人即売会
えんじにあわるつ	エンジニアワルツ	固有名詞	イベント〉同人即売会
とうほうゆうえんじゃく	東方遊宴雀	固有名詞	イベント〉同人即売会
ゆうえんじゃく	遊宴雀	固有名詞	イベント〉同人即売会
やくもげんそうさい	八雲幻想祭	固有名詞	イベント〉同人即売会
ふぉーくろあぱれーど	フォークロア・パレード	固有名詞	イベント〉同人即売会
とうほうやりんさい	東方椰麟祭	固有名詞	イベント〉同人即売会
やりんさい	椰麟祭	固有名詞	イベント〉同人即売会
とうほうけんぶんろく	東方絢文禄	固有名詞	イベント〉同人即売会
けんぶんろく	絢文禄	固有名詞	イベント〉同人即売会
だいきゅうしゅうとうほうさい	大⑨州東方祭	固有名詞	イベント〉同人即売会
だいきゅうしゅう	大⑨州	固有名詞	イベント〉同人即売会
にいがたとうほうさい	新潟東方祭	固有名詞	イベント〉同人即売会
かなざわとうほうさい	金沢東方祭	固有名詞	イベント〉同人即売会
ちゅうしこくとうほうさい	中四国東方祭	固有名詞	イベント〉同人即売会
とうほうにこどうさい	東方ニコ童祭	固有名詞	イベント〉その他
にこどうさい	ニコ童祭	固有名詞	イベント〉その他
